1111111111111111111111111
1000000000000000000000001
1000000111110001110111111
1E00C000000001111C0000001
11111000000P0000000000111
1000000000000001110111111
1000001101C1100111011E111
11C0011111111100000000111
1100111111111110000111111
11E0000000000000000000001
1111111111111111111111111