11111111111111
10000000000001
10000001110001
111000P0000001
100000000000E1
11111111111111