11111111111111
100C0000000001
10000001110001
111000P0000001
10000000000001
11111111111111