11111111111111111
1E000C00000000001
11000000000000011
11100000000000111
11110000000001111
11111111111111111