111111111111111
10000000E000001
1000000000C0001
101110000011101
1000000P0000001
100000010000001
100000111000001
100001111100001
100111111111001
111111111111111
111111111111111
